!!ATOK_TANGO_TEXT_HEADER_1
かなめ	鹿目	固有人姓
まどか	まどか	固有人名
あけみ	暁美	固有人姓
ほむら	ほむら	固有人名
みき	美樹	固有人姓
さやか	さやか	固有人名
ともえ	巴	固有人姓
まみ	マミ	固有人名
さくら	佐倉	固有人姓
きょうこ	杏子	固有人名
ももえ	百江	固有人姓
なぎさ	なぎさ	固有人名
あき	愛生	固有人姓
まばゆ	まばゆ	固有人名
かずみ	かずみ	固有人名
みさき	御崎	固有人姓
うみか	海香	固有人名
まき	牧	固有人姓
かおる	カオル	固有人名
わかば	若葉	固有人姓
みらい	みらい	固有人名
うさぎ	宇佐木	固有人姓
さとみ	里美	固有人名
かんな	神那	固有人姓
にこ	ニコ	固有人名
あさみ	浅海	固有人姓
さき	サキ	固有人名
あすか	飛鳥	固有人姓
ゆうり	ユウリ	固有人名
あんり	杏里	固有人姓
あいり	あいり	固有人名
あかね	茜	固有人姓
すみれ	すみれ	固有人名
そうじゅ	双樹	固有人姓
あやせ	あやせ	固有人名
るか	ルカ	固有人名
かずさ	和紗	固有人姓
みちる	ミチル	固有人名
しいな	椎名	固有人姓
れみ	レミ	固有人名
ひじり	聖	固有人姓
かんな	カンナ	固有人名
すばる	昴	固有人姓
みくに	美国	固有人姓
おりこ	織莉子	固有人名
くれ	呉	固有人姓
きりか	キリカ	固有人名
ちとせ	千歳	固有人姓
ゆま	ゆま	固有人名
ゆうき	優木	固有人姓
ささ	沙々	固有人名
あさこ	浅古	固有人姓
こまき	小巻	固有人名
ひとみ	人見	固有人姓
りな	リナ	固有人名
みお	美緒	固有人名
ふたば	双葉	固有人名
あかね	朱音	固有人姓
まい	麻衣	固有人名
さき	佐木	固有人姓
みやこ	京	固有人名
ますみ	真澄	固有人姓
ちか	千花	固有人名
あやの	綾野	固有人姓
ひかり	ひかり	固有人名
こいと	小糸	固有人名
あまの	天乃	固有人姓
すずね	鈴音	固有人名
ほのか	穂香	固有人姓
かなみ	佳奈美	固有人名
なるみ	成見	固有人姓
ありさ	亜里紗	固有人名
しおん	詩音	固有人姓
ちさと	千里	固有人名
ひなた	日向	固有人姓
まつり	茉莉	固有人名
かなで	奏	固有人姓
はるか	遥香	固有人名
みこと	美琴	固有人姓
つばき	椿	固有人名
かがり	華々莉	固有人名
かすみ	霞	固有人姓
いちか	壱華	固有人名
たると	タルト	固有人他
りず	リズ	固有人他
ゔぃすこんてぃ	ヴィスコンティ	固有人他
めりっさ	メリッサ	固有人他
ど	ド	固有人他
ゔぃにょる	ヴィニョル	固有人他
えりざ	エリザ	固有人他
つぇりすか	ツェリスカ	固有人他
みぬぅ	ミヌゥ	固有人他
こるぼー	コルボー	固有人他
らぴぬ	ラピヌ	固有人他
らむ	ラム	固有人他
ふれしゅ	フレシュ	固有人他
ぺれねる	ペレネル	固有人他
ふらめる	フラメル	固有人他
いざぼー	イザボー	固有人他
ばゔぃえーる	バヴィエール	固有人他
ほーくうっど	ホークウッド	固有人他
たまき	環	固有人姓
いろは	いろは	固有人名
ななみ	七海	固有人姓
やちよ	やちよ	固有人名
ゆい	由比	固有人姓
つるの	鶴乃	固有人名
ふたば	二葉	固有人姓
さな	さな	固有人名
みつき	深月	固有人姓
ふぇりしあ	フェリシア	固有人名
あずさ	梓	固有人姓
みふゆ	みふゆ	固有人名
さとみ	里見	固有人姓
とうか	灯花	固有人名
ありな	アリナ	固有人他
ぐれい	グレイ	固有人他
みなみ	水波	固有人姓
れな	レナ	固有人名
とがめ	十咎	固有人姓
ももこ	ももこ	固有人名
あきの	秋野	固有人姓
かえで	かえで	固有人名
みその	御園	固有人姓
かりん	かりん	固有人名
たつき	竜城	固有人姓
あすか	あすか	固有人名
ひいらぎ	柊	固有人姓
ねむ	ねむ	固有人名
うい	うい	固有人名
いずみ	和泉	固有人姓
かなぎ	十七夜	固有人名
やくも	八雲	固有人姓
みたま	みたま	固有人名
あまね	天音	固有人姓
つくよ	月夜	固有人名
つかさ	月咲	固有人名
きらり	煌里	固有人姓
ひかる	ひかる	固有人名
かさね	笠音	固有人姓
あお	アオ	固有人名
ときめ	時女	固有人姓
しずか	静香	固有人名
ひろえ	広江	固有人姓
ちはる	ちはる	固有人名
とき	土岐	固有人姓
すなお	すなお	固有人名
みやび	宮尾	固有人姓
しぐれ	時雨	固有人名
あずみ	安積	固有人姓
はぐむ	はぐむ	固有人名
みかげ	みかげ	固有人名
さわ	佐和	固有人姓
すだち	月出里	固有人名
ささめ	篠目	固有人姓
よづる	ヨヅル	固有人名
りゔぃあ	リヴィア	固有人他
めでぃろす	メディロス	固有人他
やよい	夜宵	固有人姓
かのこ	かのこ	固有人名
うつほ	空穂	固有人姓
なつき	夏希	固有人名
みやこ	都	固有人姓
ひなの	ひなの	固有人名
みなぎ	美凪	固有人姓
ささら	ささら	固有人名
ときわ	常磐	固有人姓
ななか	ななか	固有人名
きさき	木崎	固有人姓
えみり	衣美里	固有人名
ほずみ	保澄	固有人姓
しずく	しずく	固有人名
しのぶ	志伸	固有人姓
あきら	あきら	固有人名
くるみ	胡桃	固有人姓
まなか	まなか	固有人名
あみ	阿見	固有人姓
りあ	莉愛	固有人名
なつめ	夏目	固有人姓
かこ	かこ	固有人名
ちゅん	純	固有人姓
めいゆい	美雨	固有人名
いぶき	伊吹	固有人姓
れいら	れいら	固有人名
くみ	桑水	固有人姓
せいか	せいか	固有人名
あいの	相野	固有人姓
みと	みと	固有人名
あわね	粟根	固有人姓
こころ	こころ	固有人名
ななせ	七瀬	固有人姓
ゆきか	ゆきか	固有人名
さらさ	更紗	固有人姓
はんな	帆奈	固有人名
まりこ	毬子	固有人姓
あやか	あやか	固有人名
まお	眞尾	固有人姓
ひみか	ひみか	固有人名
すずか	鈴鹿	固有人姓
さくや	さくや	固有人名
えり	江利	固有人姓
あいみ	あいみ	固有人名
わかな	若菜	固有人姓
つむぎ	つむぎ	固有人名
いすず	五十鈴	固有人姓
れん	れん	固有人名
しずみ	静海	固有人姓
このは	このは	固有人名
ゆさ	遊佐	固有人姓
はづき	葉月	固有人名
みくり	三栗	固有人姓
あやめ	あやめ	固有人名
かがみ	加賀見	固有人姓
まさら	まさら	固有人名
はるな	春名	固有人姓
このみ	このみ	固有人名
りか	梨花	固有人名
こずえ	梢	固有人姓
まゆ	麻友	固有人名
ふみの	史乃	固有人姓
さゆき	沙優希	固有人名
めぐみ	恵	固有人姓
もか	萌花	固有人名
ちあき	千秋	固有人姓
りこ	理子	固有人名
ゆき	由貴	固有人姓
まりあ	真里愛	固有人名
あんな	安名	固有人姓
める	メル	固有人名
こまち	古町	固有人姓
みくら	みくら	固有人名
みほの	三穂野	固有人姓
せいら	せいら	固有人名
きら	吉良	固有人姓
てまり	てまり	固有人名
ゆずき	柚希	固有人姓
ほとり	ほとり	固有人名
ひびき	枇々木	固有人姓
めぐる	めぐる	固有人名
ちず	智珠	固有人姓
らんか	らんか	固有人名
りおん	りおん	固有人名
みどり	観鳥	固有人姓
りょう	令	固有人名
あおば	青葉	固有人姓
ちか	ちか	固有人名
ゆきの	雪野	固有人姓
かなえ	かなえ	固有人名
かはる	香春	固有人姓
ゆうな	ゆうな	固有人名
かざり	飾利	固有人姓
じゅん	潤	固有人名
まきの	牧野	固有人姓
いくみ	郁美	固有人名
みずき	水樹	固有人姓
るい	塁	固有人名
なつ	南津	固有人姓
りょうこ	涼子	固有人名
くろ	黒	固有人他
くろえ	黒江	固有人他
くれは	紅晴	固有人姓
ゆな	結菜	固有人名
おおば	大庭	固有人姓
じゅり	樹里	固有人名
みうら	三浦	固有人姓
あさひ	旭	固有人名
あいか	藍家	固有人姓
ひめな	ひめな	固有人名
なゆた	那由他	固有人名
ひむろ	氷室	固有人姓
らび	ラビ	固有人名
ゆめ	有愛	固有人姓
うらら	うらら	固有人名
くるす	栗栖	固有人姓
あれくさんどら	アレクサンドラ	固有人名
かぐら	神楽	固有人姓
さん	燦	固有人名
ゆかり	遊狩	固有人姓
みゆり	ミユリ	固有人名
あしゅりー	アシュリー	固有人他
ていらー	テイラー	固有人他
みわ	三輪	固有人姓
みつね	みつね	固有人名
きりの	桐野	固有人姓
さえ	紗枝	固有人名
ゆみ	ゆみ	固有人名
せな	瀬奈	固有人姓
みこと	みこと	固有人名
るり	瑠璃	固有人名
まなつ	マナツ	固有人名
つゆ	露	固有人他
みさ	ミサ	固有人名
まどかせんぱい	まどか先輩	固有人他
いろはちゃん	いろはちゃん	固有人他
ふぇりしあちゃん	フェリシアちゃん	固有人他
れなちゃん	レナちゃん	固有人他
あるてぃめっとまどかせんぱい	究極まどか先輩	固有人他
しゅぷりーむいろはちゃん	至高いろはちゃん	固有人他
