かなめ	鹿目	姓
まどか	まどか	名
あけみ	暁美	姓
ほむら	ほむら	名
みき	美樹	姓
さやか	さやか	名
ともえ	巴	姓
まみ	マミ	名
さくら	佐倉	姓
きょうこ	杏子	名
ももえ	百江	姓
なぎさ	なぎさ	名
かずみ	かずみ	名
みさき	御崎	姓
うみか	海香	名
まき	牧	姓
かおる	カオル	名
わかば	若葉	姓
みらい	みらい	名
うさぎ	宇佐木	姓
さとみ	里美	名
かんな	神那	姓
にこ	ニコ	名
あさみ	浅海	姓
さき	サキ	名
あすか	飛鳥	姓
ゆうり	ユウリ	名
あんり	杏里	姓
あいり	あいり	名
あかね	茜	姓
すみれ	すみれ	名
そうじゅ	双樹	姓
あやせ	あやせ	名
るか	ルカ	名
かずさ	和紗	姓
みちる	ミチル	名
しいな	椎名	姓
れみ	レミ	名
ひじり	聖	姓
かんな	カンナ	名
すばる	昴	姓
みくに	美国	姓
おりこ	織莉子	名
くれ	呉	姓
きりか	キリカ	名
ちとせ	千歳	姓
ゆま	ゆま	名
ゆうき	優木	姓
ささ	沙々	名
あさこ	浅古	姓
こまき	小巻	名
ひとみ	人見	姓
りな	リナ	名
みお	美緒	名
ふたば	双葉	名
あかね	朱音	姓
まい	麻衣	名
さき	佐木	姓
みやこ	京	名
ますみ	真澄	姓
ちか	千花	名
あやの	綾野	姓
ひかり	ひかり	名
こいと	小糸	名
あまの	天乃	姓
すずね	鈴音	名
ほのか	穂香	姓
かなみ	佳奈美	名
なるみ	成見	姓
ありさ	亜里紗	名
しおん	詩音	姓
ちさと	千里	名
ひなた	日向	姓
まつり	茉莉	名
かなで	奏	姓
はるか	遥香	名
みこと	美琴	姓
つばき	椿	名
かがり	華々莉	名
かすみ	霞	姓
いちか	壱華	名
たると	タルト	人名
りず	リズ	人名
ゔぃすこんてぃ	ヴィスコンティ	人名
めりっさ	メリッサ	人名
ど	ド	人名
ゔぃにょる	ヴィニョル	人名
えりざ	エリザ	人名
つぇりすか	ツェリスカ	人名
みぬぅ	ミヌゥ	人名
こるぼー	コルボー	人名
らぴぬ	ラピヌ	人名
らむ	ラム	人名
ふれしゅ	フレシュ	人名
ぺれねる	ペレネル	人名
ふらめる	フラメル	人名
いざぼー	イザボー	人名
ばゔぃえーる	バヴィエール	人名
ほーくうっど	ホークウッド	人名
たまき	環	姓
いろは	いろは	名
ななみ	七海	姓
やちよ	やちよ	名
ゆい	由比	姓
つるの	鶴乃	名
ふたば	二葉	姓
さな	さな	名
みつき	深月	姓
ふぇりしあ	フェリシア	名
あずさ	梓	姓
みふゆ	みふゆ	名
さとみ	里見	姓
とうか	灯花	名
ありな	アリナ	人名
ぐれい	グレイ	人名
みなみ	水波	姓
れな	レナ	名
とがめ	十咎	姓
ももこ	ももこ	名
あきの	秋野	姓
かえで	かえで	名
みその	御園	姓
かりん	かりん	名
たつき	竜城	姓
あすか	あすか	名
ひいらぎ	柊	姓
ねむ	ねむ	名
うい	うい	名
いずみ	和泉	姓
かなぎ	十七夜	名
やくも	八雲	姓
みたま	みたま	名
あまね	天音	姓
つくよ	月夜	名
つかさ	月咲	名
きらり	煌里	姓
ひかる	ひかる	名
かさね	笠音	姓
あお	アオ	名
ときめ	時女	姓
しずか	静香	名
ひろえ	広江	姓
ちはる	ちはる	名
とき	土岐	姓
すなお	すなお	名
みやび	宮尾	姓
しぐれ	時雨	名
あずみ	安積	姓
はぐむ	はぐむ	名
みかげ	みかげ	名
さわ	佐和	姓
すだち	月出里	名
ささめ	篠目	姓
よづる	ヨヅル	名
りゔぃあ	リヴィア	人名
めでぃろす	メディロス	人名
やよい	夜宵	姓
かのこ	かのこ	名
うつほ	空穂	姓
なつき	夏希	名
みやこ	都	姓
ひなの	ひなの	名
みなぎ	美凪	姓
ささら	ささら	名
ときわ	常磐	姓
ななか	ななか	名
きさき	木崎	姓
えみり	衣美里	名
ほずみ	保澄	姓
しずく	しずく	名
しのぶ	志伸	姓
あきら	あきら	名
くるみ	胡桃	姓
まなか	まなか	名
あみ	阿見	姓
りあ	莉愛	名
なつめ	夏目	姓
かこ	かこ	名
ちゅん	純	姓
めいゆい	美雨	名
いぶき	伊吹	姓
れいら	れいら	名
くみ	桑水	姓
せいか	せいか	名
あいの	相野	姓
みと	みと	名
あわね	粟根	姓
こころ	こころ	名
ななせ	七瀬	姓
ゆきか	ゆきか	名
さらさ	更紗	姓
はんな	帆奈	名
まりこ	毬子	姓
あやか	あやか	名
まお	眞尾	姓
ひみか	ひみか	名
すずか	鈴鹿	姓
さくや	さくや	名
えり	江利	姓
あいみ	あいみ	名
わかな	若菜	姓
つむぎ	つむぎ	名
いすず	五十鈴	姓
れん	れん	名
しずみ	静海	姓
このは	このは	名
ゆさ	遊佐	姓
はづき	葉月	名
みくり	三栗	姓
あやめ	あやめ	名
かがみ	加賀見	姓
まさら	まさら	名
はるな	春名	姓
このみ	このみ	名
りか	梨花	名
こずえ	梢	姓
まゆ	麻友	名
ふみの	史乃	姓
さゆき	沙優希	名
めぐみ	恵	姓
もか	萌花	名
ちあき	千秋	姓
りこ	理子	名
ゆき	由貴	姓
まりあ	真里愛	名
あんな	安名	姓
める	メル	名
こまち	古町	姓
みくら	みくら	名
みほの	三穂野	姓
せいら	せいら	名
きら	吉良	姓
てまり	てまり	名
ゆずき	柚希	姓
ほとり	ほとり	名
ひびき	枇々木	姓
めぐる	めぐる	名
ちず	智珠	姓
らんか	らんか	名
りおん	りおん	名
みどり	観鳥	姓
りょう	令	名
あおば	青葉	姓
ちか	ちか	名
ゆきの	雪野	姓
かなえ	かなえ	名
かはる	香春	姓
ゆうな	ゆうな	名
かざり	飾利	姓
じゅん	潤	名
まきの	牧野	姓
いくみ	郁美	名
みずき	水樹	姓
るい	塁	名
なつ	南津	姓
りょうこ	涼子	名
くろ	黒	人名
くろえ	黒江	人名
くれは	紅晴	姓
ゆな	結菜	名
おおば	大庭	姓
じゅり	樹里	名
みうら	三浦	姓
あさひ	旭	名
あいか	藍家	姓
ひめな	ひめな	名
なゆた	那由他	名
ひむろ	氷室	姓
らび	ラビ	名
ゆめ	有愛	姓
うらら	うらら	名
くるす	栗栖	姓
あれくさんどら	アレクサンドラ	名
かぐら	神楽	姓
さん	燦	名
ゆかり	遊狩	姓
みゆり	ミユリ	名
ゆみ	ゆみ	名
せな	瀬奈	姓
みこと	みこと	名
るり	瑠璃	名
まなつ	マナツ	名
